Rows: 20
Colums: 30
000000111110000000000000000000
010000001000000011111100000000
010010001000000000000100000000
010010000000000000000100000000
010010001100000000000111100000
010010000100000000000000000000
000011111100001001100100000100
000000000000001001100100011100
000000000000001111111100000100
000011111100001000000000000000
000000000000001000000000111100
001000000100001000000000000100
001100000100111111000000000100
000110000100000000000000000100
000011000100000000000010000000
000000000000000010000010000000
000000000000000010000010000000
000001111111000010000011110000
000000000000000010000000000000
000000000000000000000000000000
